9
19
WWWWWWWWWWWWWWWWWWW
WRRWRRWRRWRRWRRWRRW
WDWWDWWDWWDWWDWWDWW
WCCCCCCCCCCCCCCCCCW
WCCCCCCCCCCCCCCCCCW
WWDWWCCWWDWWCCWWDWW
WRRRDCCDRRRDCCDRRRW
WRRRWCCWRRRWCCWRRRW
WWWWWWWWWWWWWWWWWWW